111111111111111111111111111111111111111
1PPPPP0P0000000PP000000000C00000000EPP1
1000000000000000C000000000000PPC0PPPPP1
111111111111111111111111111111111111111
