11111111
11CP0001
11CP1001
1001E001
11111111
